#Operator name	Object	ObjectUtils	method	Description
setAnnotationProperty	Annotation		void setProperty(String key, String value)	Set an annotation property
getAnnotationProperty	Annotation		String getProperty(String key)	Get an annotation property
removeAnnotationProperty	Annotation		void removeProperty(String key)	Remove an annotation property
getAnnotationCount	Annotation		int size()	Get the count of annotations
clearProperties	Annotation		void clear()
getAnnotationsPropertiesKeys	Annotation		String[] getPropertiesKeys()
containsProperty	Annotation		boolean containsProperty(String key)

getBioAssayName	BioAssay		String getName()
setBioAssayName	BioAssay		void setName(String name)
getBioAssayAnnotation	BioAssay		Annotation getAnnotation()
filterBioAssay	BioAssay		BioAssay filter(BioAssayFilter filter)
countBioAssayAfterFilter	BioAssay		int count(BioAssayFilter filter)
clearBioAssay	BioAssay		void clear()
sizeOfBioAssay	BioAssay		int size()

getBioAssayReds	BioAssay		int[] getReds()
getBioAssayGreens	BioAssay		int[] getGreens()
getBioAssayIds	BioAssay		String[] getIds()
getBioAssayFlags	BioAssay		int[] getFlags()
getBioAssayDescriptions	BioAssay		String[] getDescriptions()
getBioAssayAs	BioAssay		double[] getAs()
getBioAssayMs	BioAssay		double[] getMs()
getBioAssayStdDevAs	BioAssay		double[] getStdDevAs()
getBioAssayStdDevMs	BioAssay		double[] getStdDevMs()
isBioAssayGreens	BioAssay		boolean isGreens()
isBioAssayReds	BioAssay		boolean isReds()
isBioAssayRatios	BioAssay		boolean isRatios()
isBioAssayFlags	BioAssay		boolean isFlags()
isBioAssayDescriptions	BioAssay		boolean isDescriptions()
isBioAssayAs	BioAssay		boolean isAs()
isBioAssayMs	BioAssay		boolean isMs()
isBioAssayStdDevAs	BioAssay		boolean isStdDevAs()
isBioAssayStdDevMs	BioAssay		boolean isStdDevMs()
getBioAssayRatios	BioAssay		double[] getRatios()
setBioAssayFlags	BioAssay		void setFlags(int[] flags)
setBioAssayGreens	BioAssay		void setGreens(int[] greens)
setBioAssayReds	BioAssay		void setReds(int[] reds)
setBioAssayRatios	BioAssay		void setRatios(double[] ratios)
setBioAssayIds	BioAssay		void setIds(String[] ids)
setBioAssayDescriptions	BioAssay		void setDescriptions(String[] descriptions)
setBioAssayAs	BioAssay		void setAs(double[] as)
setBioAssayMs	BioAssay		void setMs(double[] ms)
setBioAssayStdDevAs	BioAssay		void setStdDevAs(double[] stdDevAs)
setBioAssayStdDevMs	BioAssay		void setStdDevMs(double[] stdDevMs)
removeBioAssayFlags	BioAssay		void removeFlags()
removeBioAssayGreens	BioAssay		void removeGreens()
removeBioAssayReds	BioAssay		void removeReds()
removeBioAssayRatios	BioAssay		void removeRatios()
removeBioAssayIds	BioAssay		void removeIds()
removeBioAssayDescriptions	BioAssay		void removeDescriptions()
removeBioAssayAs	BioAssay		void removeAs()
removeBioAssayMs	BioAssay		void removeMs()

swapBioAssayIdentifiersAndDescriptions	BioAssay		void swapIdentifiersAndDescriptions()

getBioAssayDataFieldInt	BioAssay		int[] getDataFieldInt(String field)
getBioAssayDataFieldDouble	BioAssay		double[] getDataFieldDouble(String field)
getBioAssayDataFieldString	BioAssay		String[] getDataFieldString(String field)
getBioAssayFields	BioAssay		String[] getFields()
getBioAssayFieldCount	BioAssay		int getFieldCount()
getBioAssayLocations	BioAssay		int[] getLocations()
isBioAssayField	BioAssay		boolean isField(String field)
setBioAssayDataFieldInt	BioAssay		void setDataFieldInt(String field, int[] value)
setBioAssayDataFieldDouble	BioAssay		void setDataFieldDouble(String field, double[] value)
setBioAssayDataFieldString	BioAssay		void setDataFieldString(String field, String[] value)
setBioAssayLocations	BioAssay		void setLocations(int[] locs)
removeBioAssayLocations	BioAssay		boolean removeLocations()
removeBioAssayField	BioAssay		void removeField(String field)
getBioAssayFieldType	BioAssay		int getFieldType(String field)
isBioAssayLocations	BioAssay		boolean isLocations()
renameBioAssayField	BioAssay		void renameField(String oldName, String newName)
swapBioAssayFields	BioAssay		void swapFields(String fieldA, String fieldB)

removeRowsFromBioAssay	BioAssay	BioAssayUtils	BioAssay removeRowsFromBioAssay(BioAssay bioAssay, int[] rowsToRemove)
calcBioAssayMA	BioAssay	BioAssayUtils	void calcMA(BioAssay bioAssay)
swapBioAssay	BioAssay	BioAssayUtils	void swap(BioAssay bioAssay)
calcBioAssayRatios	BioAssay	BioAssayUtils	void calcRatio(BioAssay bioAssay)
replaceBioAssayIdsByAnnotation	BioAssay	BioAssayUtils	void replaceIdsByAnnotation(BioAssay bioAssay, Translator annotation, String annotationField, String unknowId)
mergeBioAssay	BioAssay	BioAssayUtils	BioAssay merge(BioAssay a, BioAssay b)
addTranslationsToBioAssay	BioAssay	BioAssayUtils	void addTranslationsToBioAssay(BioAssay bioAssay, Translator translator)

getTranslatorDefaultField	Translator		String getDefaultField()
setTranslatorDefaultField	Translator		void setDefaultField(String field)
getTranslatorFields	Translator		String[] getFields()
translateField	Translator		String[] translateField(String[] ids, String field)
isTranslatorField	Translator		boolean isField(String field)


getBiologicalListName	BiologicalList		String getName()
setBiologicalListName	BiologicalList		void setName(String name)
addElementToBiologicalList	BiologicalList		void add(String element)
addStringListToBiologicalList	BiologicalList		void add(String[] list)
addBiologicalListToBiologicalList	BiologicalList		void add(BiologicalList list)
removeElementFromBiologicalList	BiologicalList		void remove(String element)
removeStringListFromBiologicalList	BiologicalList		void remove(String[] list)
removeBiologicalListFromBiologicalList	BiologicalList		void remove(BiologicalList list)
clearBiologicalList	BiologicalList		void clear()
sizeOfBiologicalList	BiologicalList		int size()
BiologicalListToStringList	BiologicalList		String[] toArray()
BiologicalListContains	BiologicalList		boolean contains(String element)
concatBiologicalLists	BiologicalList		BiologicalList concat(BiologicalList list)
includeBiologicalList	BiologicalList		BiologicalList include(BiologicalList list)
excludeBiologicalList	BiologicalList		BiologicalList exclude(BiologicalList list)
excludeAllBiologicalList	BiologicalList		BiologicalList excludeAllLists(BiologicalList list)
filterBiologicalList	BiologicalList		BiologicalList filter(BiologicalListFilter filter)
grepBiologicalList	BiologicalList		BiologicalList grep(String regex)
BiologicalListStartWith	BiologicalList		BiologicalList startsWith(String prefix)
BiologicalListEndsWith	BiologicalList		BiologicalList endsWith(String suffix)
BiologicalListToLowerCase	BiologicalList		BiologicalList toLowerCase()
BiologicalListToUpperCase	BiologicalList		BiologicalList toUpperCase()
BiologicalListTrim	BiologicalList		BiologicalList trim()
BiologicalListRemoveIdentifiersNumbers	BiologicalList		BiologicalList removeIdentifersNumbers()
BiologicalListEquals	BiologicalList		boolean equals(BiologicalList list)


getMatrixName	ExpressionMatrix		String getName()
setMatrixName	ExpressionMatrix		void setName(String name)
getMatrixSize	ExpressionMatrix		int size()
clearMatrix	ExpressionMatrix		void clear()
getMatrixAnnotation	ExpressionMatrix		Annotation getAnnotation()
filterMatrix	ExpressionMatrix		ExpressionMatrix filter(ExpressionMatrixFilter filter)
addBioAssayToMatrix	ExpressionMatrix		void addBioAssay(BioAssay bioAssay, String columnName)
addDesignToMatrix	ExpressionMatrix		void addDesign(Design design)
addMatrixToMatrix	ExpressionMatrix		void addMatrix(ExpressionMatrix matrix, boolean overwriteColumns)
getMatrixDimension	ExpressionMatrix		ExpressionMatrixDimension getDimension(String dimensionName)
addDimensionToMatrix	ExpressionMatrix		void addDimension(String dimensionName)
removeDimensionFromMatrix	ExpressionMatrix		void removeDimension(String dimensionName)
renameDimensionFromMatrix	ExpressionMatrix		void renameDimension(String oldName, String newName)
getDefaultMatrixDimension	ExpressionMatrix		ExpressionMatrixDimension getDefaultDimension()
setDefaultMatrixDimensionName	ExpressionMatrix		void setDefaultDimensionName(String name)
getMatrixDefaultDimensionName	ExpressionMatrix		String getDefaultDimensionName()
renameMatrixRow	ExpressionMatrix		void renameRow(String formerName, String newName)
renameMatrixColumn	ExpressionMatrix		void renameColumn(String formerName, String newName)
removeMatrixRow	ExpressionMatrix		void removeRow(String rowId)
removeMatrixColumn	ExpressionMatrix		void removeColumn(String columnName)
subMatrixRows	ExpressionMatrix		ExpressionMatrix subMatrixRows(String[] rowsId)
subMatrixRowsExclude	ExpressionMatrix		ExpressionMatrix subMatrixRowsExclude(String[] rowsId)
subMatrixColumns	ExpressionMatrix		ExpressionMatrix subMatrixColumns(String[] columns)
subMatrixColumnsExclude	ExpressionMatrix		ExpressionMatrix subMatrixColumnsExclude(String[] columns)
subMatrixDimensions	ExpressionMatrix		ExpressionMatrix subMatrixDimensions(String[] dimensionNames)
subMatrixDimensionsExclude	ExpressionMatrix		ExpressionMatrix subMatrixDimensionsExclude(String[] dimensionNames)
getMatrixDimensionCount	ExpressionMatrix		int getDimensionCount()
containsMatrixDimension	ExpressionMatrix		boolean containsDimension(String name)
getMatrixDimensionNames	ExpressionMatrix		String[] getDimensionNames()
getMatrixDimensions	ExpressionMatrix		ExpressionMatrixDimension[] getDimensions()
getMatrixColumn	ExpressionMatrix		BioAssay getColumn(String columnName)
addColumnToMatrix	ExpressionMatrix		void addColumn(String columnName)
addRowToMatrix	ExpressionMatrix		void addRow(String rowName)
getMatrixColumnCount	ExpressionMatrix		int getColumnCount()
getMatrixRowCount	ExpressionMatrix		int getRowCount()
getMatrixColumnName	ExpressionMatrix		String getColumnName(int columnNumber)
getMatrixColumnNames	ExpressionMatrix		String[] getColumnNames()
getMatrixRowNames	ExpressionMatrix		String[] getRowNames()
containsMatrixColumn	ExpressionMatrix		boolean containsColumn(String columnName)
containsMatrixRow	ExpressionMatrix		boolean containsRow(String rowName)


getDimensionRowToArray	ExpressionMatrixDimension		double[] getRowToArray(String rowName)
setDimensionValues	ExpressionMatrixDimension		void setValues(String[] ids, String columnName, double[] values)
getDimensionColumnToArray	ExpressionMatrixDimension		double[] getColumnToArray(String columnName)
getDimensionValue	ExpressionMatrixDimension		double getValue(String id, String columnName)
setMatrixValue	ExpressionMatrixDimension		void setValue(String id, String columnName, double value)

swapMatrix	ExpressionMatrix	ExpressionMatrixUtils	void swap(ExpressionMatrix expressionMatrix, String columnName)
centringMatrixColumns	ExpressionMatrix	ExpressionMatrixUtils	void centringColumns(ExpressionMatrix expressionMatrix)
centringMatrixRows	ExpressionMatrix	ExpressionMatrixUtils	void centringRows(ExpressionMatrix expressionMatrix)
scalingMatrixColumns	ExpressionMatrix	ExpressionMatrixUtils	void scalingColumns(ExpressionMatrix expressionMatrix)
scalingMatrixRows	ExpressionMatrix	ExpressionMatrixUtils	void scalingRows(ExpressionMatrix expressionMatrix)
renameMatrixIdsWithTranslator	ExpressionMatrix	ExpressionMatrixUtils	void renameIdsWithTranslator(ExpressionMatrix expressionMatrix, Translator translator, boolean keepUntranslatedIds)


centringDimensionColumns	ExpressionMatrixDimension	ExpressionMatrixUtils	void centringColumns(ExpressionMatrixDimension expressionMatrixDimension)
centringDimensionRows	ExpressionMatrixDimension	ExpressionMatrixUtils	void centringRows(ExpressionMatrixDimension expressionMatrixDimension)
scalingDimensionColumns	ExpressionMatrixDimension	ExpressionMatrixUtils	void scalingColumns(ExpressionMatrixDimension expressionMatrixDimension)
scalingDimensionRows	ExpressionMatrixDimension	ExpressionMatrixUtils	void scalingRows(ExpressionMatrixDimension expressionMatrixDimension)

isDesignLabel	Design		boolean isLabel(String name)
addDesignLabel	Design		void addLabel(String name)
renameDesignLabel	Design		void renameLabel(String oldName, String newName)
getDesignLabelsNames	Design		List<String> getLabelsNames()
removeDesignLabel	Design		void removeLabel(String name)
getDesignLabelCount	Design		int getLabelCount()
isDesignSlide	Design		boolean isSlide(String name)
addDesignSlide	Design		void addSlide(String name)
renameDesignSlide	Design		void renameSlide(String oldName, String newName)
getDesignSlidesNames	Design		List<String> getSlidesNames()
removeDesignSlide	Design		void removeSlide(String name)
getDesignSlideCount	Design		int getSlideCount()
setDesignTarget	Design		void setTarget(String slide, String label, String sample)
getDesignTarget	Design		String getTarget(String slide, String label)
setDesignSource	Design		void setSource(String slideName, String filename)
setDesignSourceFormat	Design		void setSourceFormat(String slideName, String formatName)
getDesignSourceInfo	Design		String getSourceInfo(String slideName)
setDesignBioAssay	Design		void setBioAssay(String slideName, BioAssay bioassay)
getDesignBioAssay	Design		BioAssay getBioAssay(String slideName)
isDesignDescriptionField	Design		boolean isDescriptionField(String name)
addDesignDescriptionField	Design		void addDescriptionField(String name)
renameDesignDescriptionField	Design		void renameDescriptionField(String oldName, String newName)
getDesignDescriptionFieldsNames	Design		List<String> getDescriptionFieldsNames()
removeDesignDescriptionField	Design		void removeDescriptionField(String name)
getDesignDescriptionFieldCount	Design		int getDescriptionFieldCount()
setDesignDescription	Design		void setDescription(String slide, String descriptionField, String value)
getDesignScanLabelSetting	Design		String getScanLabelSetting(String slide, String label, String key)
setDesignScanLabelSetting	Design		void setScanLabelSetting(String slide, String label, String setting, String value)
isDesignScanLabelSetting	Design		boolean isScanLabelSetting(String setting)
addDesignScanLabelSetting	Design		void addScanLabelSetting(String setting)
renameDesignScanLabelSetting	Design		void renameScanLabelSetting(String oldName, String newName)
getDesignScanLabelSettingsKeys	Design		List<String> getScanLabelSettingsKeys()
removeDesignScanLabelSetting	Design		void removeScanLabelSetting(String setting)
loadDesignAllSources	Design		void loadAllSources()
swapDesignAllSlides	Design		void swapAllSlides()
